11111111111
10000000C01
1000010E111
10000P11111
11111111111
11111111110