11111111111
100C0000001
1000011E111
10000P11111
11111111111
