11111111111111111111
10000000C00000000001
1000010E11000000C001
10000P111100C000C001
11111111111111111111