11111111111111111111
10C00000C00000000001
100010011000000C0001
1E0000111100C000C0P1
11111111111111111111